隔絶戰戰	≪동떨어ㅈㅣㄴ∬&≫	0
歯ぎしりを戰戰	≪이를 ㄱㅏㄹ∬&≫	0
足音が戰戰	≪발소리가 ㄴㅏㄴ∬&≫	0
どろんと戰戰	≪흐리멍텅ㅎㅏㄴ∬&≫	0
身震い戰戰	≪몸서리 ㅊㅣㄴ∬&≫	0
むちっと戰戰	≪포동ㅎㅏㄴ∬&≫	0	//むちっとしたママの尻は
ぼんやり戰戰	≪희미ㅎㅏㄴ∬&≫	0
ぼんやりと戰戰	≪어렴풋ㅎㅏㄴ∬&≫	0
付随戰戰	≪뒤따ㄹㅡㄴ∬&≫	0
念押し戰戰	≪거듭 다짐ㅎㅏㄴ∬&≫	0
見劣りが戰戰	≪모자ㄹㅏㄴ∬&≫	0
見劣り戰戰	≪모자ㄹㅏㄴ∬&≫	0
陥落戰戰	≪함락ㄷㅚㄴ∬&≫	0
木霊戰戰	≪메아리ㅊㅣㄴ∬&≫	0
愚弄戰戰	≪우롱ㅎㅏㄴ∬&≫	0
絶頂戰戰	≪절정ㅎㅏㄴ∬&≫	0
瞠目戰戰	≪눈을 둥그렇게 ㄸㅡㄴ∬&≫	0
借り戰戰	≪빌ㄹㅣㄴ∬&≫	0
考え事を戰戰	≪생각을 ㅎㅏㄴ∬&≫	0
仁王立ち戰戰	≪우뚝 서있ㄴㅡㄴ∬&≫	0	//工藤先生が校門脇で仁王立ちしていた。
洗練戰戰	≪세련ㄷㅚㄴ∬&≫	0
再燃戰戰	≪다시 불타오ㄹㅡㄴ∬&≫	0
瞑目戰戰	≪눈을 감ㄴㅡㄴ∬&≫	0
絶句戰戰	≪말문이 막ㅎㅣㄴ∬&≫	0
羽休め戰戰	≪날개를 쉬게 ㅎㅏㄴ∬&≫	0
すっきり戰戰	≪후련ㅎㅏㄴ∬&≫	0
さびしい思いを戰戰	≪쓸쓸ㅎㅏㄴ∬&≫	0
選り好み戰戰	≪편식ㅎㅏㄴ∬&≫	0
夜なべ戰戰	≪밤을 새ㅇㅜㄴ∬&≫	0
送り迎え戰戰	≪바래다 ㅈㅜㄴ∬&≫	0

ヶにかっと	씨익하고	0	//にかっと笑う。

ボンヤリ	멍하니∥t	0
やんわり	부드럽게∥t	0

ご都合主義	편의주의	0

ぷくく	푸후훗	0
メスの顔	암컷의 얼굴	0
カウパー汁	쿠퍼액	0
修道着	수도복	0
シスター	시스터	0
すえた匂い	시큼한 냄새	0
嘘つき	거짓말쟁이#M	0
天啓	하늘의 계시#M	0
//なのだ	것이다	
辨明#M	변명	0
女魔導師#M	여마도사	0
暴挙	폭거#M	0
柱頭	기둥머리#M	0
//疑い	의심	0
合致	일치@@	0
ゴミクズ	쓰레기#M	0
なまじ才能	어설픈 재능#M	0
//皮肉	아이러니#M	0
化け狐	괴물여우#M	1
糞食え	엿 먹어	0
ひれ伏し	넙죽 엎드려	0
息の一吹き	입김 한 번	0
狐面	여우가면#N	0
躊躇いがちに	주저하면서	0
知恵比べ	지혜겨루기#M	1
神狐	여우 신#M	1
酷暑	무더위#M	1
目前	코앞#M	1
艶聞	염문#M	1
数瞬	찰나#M	1
前途	앞길#M	0
齧りかけの	한 입 베어물은	0
くそったれな	빌어먹을	0
等間隔	같은 가격#M	0
狐の面	여우가면#M	0
お世辞にも	빈말이라도	0
神の如き	신과 같은	0
お望みの通り	원하시는 대로	0
意気込み	기세#M	0
ターバン	터번#M	0
大体、	애시당초,	0
//っぷり	한 척	0
勝手	제멋대로	0
褒章	포상#M
婉曲的な	완곡한	0
神妙に	얌전하게	0
衣服の内	옷의 안
クラン	클랜#M
立ち回り先	도망처#M
立回り先	도망처#M
//談	말#M
早口で	빠르게	0
有耶無耶	유야무야#M
状態	상태#M	1
鍛冶師	대장장이#M
回数	횟수#M	0
忍術	인술#M
御前	어전#M
美丈夫	미남#M
心使い	마음씀씀이#M
あれ程	그렇게	0
ローパー	로퍼#M
角笛	뿔피리#M
襞状	주름모양
肉びら	소음순#M	1	VBp
カリ首	귀두 아래#M	1	VBp
ドットコム	닷컴#M
長期休み	장기 휴일#M	//長期休みにしかできない経験や体験を
わかりきった	뻔한	0
分り切った	뻔한	0
わり切った	뻔한	0
分りきった	뻔한	0
グポグポ	꿀럭꿀럭	0
ポテンシャル	포텐셜#M
談話室	담화실#M
書き出し文	글의 첫머리#M
門前	문 앞#M
リアリズム	리얼리즘	0
輪まわし	굴렁쇠#M
小供	어린애#M
蜜壷	꿀단지#M
金切り音	쇳소리#M
トランポリン	트램펄린#M
ラストスパート	라스트 스퍼트#M
襞	주름#M
脳髄	뇌수#M
子宮口	자궁구#M
微塵	조금	0
眼力	안력#M
命懸けの	목숨을 건 	0
命がけの	목숨을 건 	0
泡立ち石鹸	거품비누#M
サイクロン	사이클론#M
バニーガール	바니걸#M
レベルアップ	레벨 업#M
実力至上	실력 지상#M
至上	최상#M	0
レガシー	레거시#M
猛然と	맹렬하게	0
ぐぬぬ	흐으음	0
無理無体に	강제로	0
無体	무리	0
蜘蛛の糸	거미줄#M
一心不乱に	일심불란하게	0
薄笑み	엷은 미소
//坊や梦名	꼬맹이#M
うわ言	혼잣말#M
そうこうしている内	그러는 동안#M	0
金切声	날카로운 소리#M	1
金切り声	날카로운 소리#M	1
春草	음모#M	1	VBp
霜降り肉	마블링#M
全箇所	모든 곳#M
箇所	장소#M
豊尻	풍만한 엉덩이#M
尊厳	존엄#M
尻朶	볼기#M
淫語	추잡한 말#M
ラインナップ	라인업#M
感心しきり	감탄의 연속
自ずと	저절로	0
フルフェイス	풀 페이스#M
薄水色	옅은 하늘색
顔立ち	용모#M
愛好会	애호회#M
球の汗	구슬땀#M
肉袋	고기주머니#M
化粧っ気	화장기#M
煽り文句	도발#M
くぐもった声	우물거리는 소리#M
せめてもの救い	그나마의 위안	0
後講釈	뒷북#M
講釈	설명#M
これ見よがし	보란 듯이	0
巨根	거근#M
慰み物	노리개#M
杭打ち	말뚝박기
おくちマンコ	입보지#M	1	VBp
ポルチオ	포르치오#M	1	VBp
峠道	고갯길
うひょお	우효오
ひょおお	효오오
急勾配	급경사
沖合い	먼 바다
タイ人	태국인
さらっとした口跡	가벼운 말투	0
どんぶり	돈부리#M	0
デッキ	덱#M
プレイング	플레이
ゴショウ	후추#M
一振りの剣	한 자루의 검
宝具	보구#M
剣型	검형#M
生垣	산울타리
校門脇	교문 옆#M	1	VBl
切れ長の眉毛	길게 자른 눈썹#M	1	VBp
ジェノサイダー	제노사이더#M
黒尽くめ	검정 일색
片手間	틈틈이
モトカノ	전 여친#M
草刈鎌	풀 베는 낫#M	1	VPe
紙皿	일회용 접시#M	1	VPe
ペニス	페니스#M	1	VBp
断端	절단면#M	1
ど田舎	깡촌#M
ファイティング	파이팅
怒号	고함#M
途上	도중
リチャード獅子心王	리처드 사자심왕#N	1	VBp
サラディン	살라딘#N	1	VBp
床	바닥#M	1	//先生の床についた腕のひじが、なお深くなった。
ラフな格好	편안한 차림#M	0
日中	낮#M	1	UMe
箒梦名がけ	빗자루질#M	1
買い替え	교체
ハンバーグ	햄버그#M	1	VFd
スカジャン	스카쟌#M	1	VCp
擬音	효과음#M	1	UHr
バックミラー	백미러#M
どぶ	시궁창#M	1
エノキタケ	팽이버섯#M	1	VFd
懸命さ	노력#M	1
うらめしや	원망스럽구나	0	//귀신 대사
外鍵	바깥 자물쇠#M	1
燕返し	츠바메가에시#M	1
便座	변기#M	1
戸越し	문 너머#M	1
バンダム	밴텀#M	1
上の前歯	위의 앞니#M	1	//上の前歯が欠けているのがわかった。
夕食どき	저녁식사 시간#M	UMe
靴あと	신발자국#M	1
参軍	참모#M	1
首の付け根	목덜미#M	1
プールサイド	풀사이드#M	1	VPl
御守り	부적#M	1
丸椅子	둥근 의자#M	1
灰塵	재와 먼지#M	1
何体	몇놈#M	1	//あと何体！？
卵形	달걀 모양#M	1
蛍光灯	형광등#M	1
血振り	피털기#M	1
冷めた目	싸늘한 눈#M	1
優しげ	상냥한##
幹事長	간사장#M	1
母君	어머님#M	1
靴先	구두코#M	1
越し	너머
樹木	수목#M	1
インプ	임프#M
千天万花	천천만화#M	1
武帝祭	무제제#M
大磯	오오이소#M	1	QCT
ヒューマン	휴먼#M	1	QNP
藪	수풀#M	0	VPt
後詰	후방 부대#M	1
リザードマン	리자드맨#M
仕立て直	새로 지은 옷#M
指先	손끝#M	1	VBp
頸動脈	경동맥#M	1	VBp
頸静脈	경정맥#M	1	VBp
頸血	경혈#M	1	VBp
頸	목#M	1	VBp
闘技場	투기장#M	1
はにかみ顔	수줍은 얼굴#M	0
腹黒	하라구로#M	0
隣端	옆 가장자리#M	1
封ろう	봉랍#M	1
自棄	자포자기#M	1
蜜	꿀#M	1

//오역 위험 있음
//その癖	그럼에도	0
あろうことか	하필이면	0
有ろうことか	하필이면	0
はじめこそ	직후에는	0
従順な	순종적인	0
出場所	나설 자리#M	0
囚われの	붙잡힌	0
新米	신참	0
ツボ	급소#M
幾つも	여럿
幹	줄기#M
自らの	자신의	0
シャレた	세련된
あのな	저기 말이야	0
伏目がちに	눈을 내리뜨고	0
伏目がち	눈을 내리뜸

心当り	짐작가는 곳#M
心当たり	짐작가는 곳#M

//문구
神がかっていた	신들려있었다	0
ごめんだが	사양이지만	0
ごめんだ	사양이다	0
びっくりだよ	놀랐다고	0
なにがなにやら	뭐가 뭔지	0
味が分からない	맛을 모르겠다	0 //焦りのせいか味がわからない
やる気なものようだ	할 생각인 것 같다	0
やる気なものようで	할 생각인 것 같아서	0
我慢なりません	참을 수 없습니다	0
使えもしない	##쓰지도 못하는	0
ためではなく	때문이 아니라	0
役に立ていない	도움이 되지 않는다	0
仕出かしたら	저지른다면	0
してもいないのに	하지도 않았는데	0
にも拘らず	그럼에도 불구하고	0
意に介することなく	개의치 않고	0
介することなく	개의치 않고	0
介する事無く	개의치 않고	0
うず高く	수북이	0
今回ばかりは	이번만큼은	0
余りいい手	그다지 좋은 수#M	0	//余りいい手とは思えないな
そもそも	애초에	0
並々ならぬ	예사롭지 않은	0
有無を言わさず	다짜고짜	0
判然としない	확실치 않다	0
試しとばかりに	시험삼아	0
早いもので	빠르게도	0	//早いものでもう終わろうとしています
同様に	마찬가지로	0
今度こそ	이번에야 말로	0
ご心配には及びません	걱정하실 것 없습니다	0
フレンドリーに	친근하게	0
気は使わず	배려하지 말고	0
願い虚しく	내심 기대했지만	0
接せば	접하면	0
同じくせに	같은 주제에	0
